S.....XXXXX...X
.....XX...XX..X
XX...XX..XXX..X
XX...XXX.....XX
...X.....XX...X
.....XX...X...X
XX...XXX.....XX
....XX....XX..X
XX......X....XX
....XX.....XXXX
..XX....X...XXX
XXXX...XXX.....
X....XX....XX..
XX....XXX...X..
...XX.........E
